wwwwwwwwwwwwwwwwwwwww
w-p-----------------w
w-----ew------------w
w-+-----------------w
w-------------------w
w-------------------w
w-----------c-------w
w-------------------w
w-----------E-------w
wwwwwwwwwwwwwwwwwwwww
